{
  "wall"    : 0,
  "food"    : 1,
  "empty"   : 2,
  "pill"    : 3,
  "e_spawn" : 4,
  "p_spawn" : 5,
  "levels"  : [
    [[0, 0, 0, 0, 0, 0, 0, 0, 0, 0, 0, 0, 0, 0, 0, 0, 0, 0, 0],
  	[0, 1, 1, 1, 1, 1, 1, 1, 1, 0, 1, 1, 1, 1, 1, 1, 1, 1, 0],
  	[0, 3, 0, 0, 1, 0, 0, 0, 1, 0, 1, 0, 0, 0, 1, 0, 0, 3, 0],
  	[0, 1, 0, 0, 1, 0, 0, 0, 1, 0, 1, 0, 0, 0, 1, 0, 0, 1, 0],
  	[0, 1, 1, 1, 1, 1, 1, 1, 1, 1, 1, 1, 1, 1, 1, 1, 1, 1, 0],
  	[0, 1, 0, 0, 1, 0, 1, 0, 0, 0, 0, 0, 1, 0, 1, 0, 0, 1, 0],
  	[0, 1, 1, 1, 1, 0, 1, 1, 1, 0, 1, 1, 1, 0, 1, 1, 1, 1, 0],
  	[0, 0, 0, 0, 1, 0, 0, 0, 1, 0, 1, 0, 0, 0, 1, 0, 0, 0, 0],
  	[2, 2, 2, 0, 1, 0, 1, 1, 1, 1, 1, 1, 1, 0, 1, 0, 2, 2, 2],
  	[2, 2, 2, 0, 1, 0, 1, 0, 0, 4, 0, 0, 1, 0, 1, 0, 2, 2, 2],
  	[2, 2, 2, 0, 1, 1, 1, 0, 4, 4, 4, 0, 1, 1, 1, 0, 2, 2, 2],
  	[2, 2, 2, 0, 1, 0, 1, 0, 0, 0, 0, 0, 1, 0, 1, 0, 2, 2, 2],
  	[2, 2, 2, 0, 1, 0, 1, 1, 1, 5, 1, 1, 1, 0, 1, 0, 2, 2, 2],
  	[0, 0, 0, 0, 1, 0, 1, 0, 0, 0, 0, 0, 1, 0, 1, 0, 0, 0, 0],
  	[0, 1, 1, 1, 1, 1, 1, 1, 1, 0, 1, 1, 1, 1, 1, 1, 1, 1, 0],
  	[0, 1, 0, 0, 1, 0, 0, 0, 1, 0, 1, 0, 0, 0, 1, 0, 0, 1, 0],
  	[0, 3, 1, 0, 1, 1, 1, 1, 1, 1, 1, 1, 1, 1, 1, 0, 1, 3, 0],
  	[0, 0, 1, 0, 1, 0, 1, 0, 0, 0, 0, 0, 1, 0, 1, 0, 1, 0, 0],
  	[0, 1, 1, 1, 1, 0, 1, 1, 1, 0, 1, 1, 1, 0, 1, 1, 1, 1, 0],
  	[0, 1, 0, 0, 0, 0, 0, 0, 1, 0, 1, 0, 0, 0, 0, 0, 0, 1, 0],
  	[0, 1, 1, 1, 1, 1, 1, 1, 1, 1, 1, 1, 1, 1, 1, 1, 1, 1, 0],
  	[0, 0, 0, 0, 0, 0, 0, 0, 0, 0, 0, 0, 0, 0, 0, 0, 0, 0, 0]]
  ]
}
